//MAP CONVERTED BY dmm2tgm.py THIS HEADER COMMENT PREVENTS RECONVERSION, DO NOT REMOVE
"aa" = (
/turf/template_noop,
/area/template_noop)
"ab" = (
/turf/template_noop,
/area/submap/CaveS)
"ac" = (
/obj/item/ammo_casing/a45,
/turf/template_noop,
/area/submap/CaveS)
"ad" = (
/turf/simulated/mineral/ignore_mapgen,
/area/submap/CaveS)
"ae" = (
/obj/item/ammo_casing/a45,
/obj/item/reagent_containers/food/snacks/xenomeat/spidermeat,
/turf/template_noop,
/area/submap/CaveS)
"af" = (
/obj/random/landmine,
/turf/template_noop,
/area/submap/CaveS)
"ag" = (
/obj/item/ammo_casing/a45,
/obj/random/landmine,
/turf/template_noop,
/area/submap/CaveS)
"ah" = (
/obj/random/landmine,
/turf/simulated/floor/outdoors/dirt{
	outdoors = 0
	},
/area/submap/CaveS)
"ai" = (
/obj/effect/spider/stickyweb,
/turf/simulated/floor/outdoors/dirt{
	outdoors = 0
	},
/area/submap/CaveS)
"aj" = (
/obj/item/ammo_casing/a45,
/obj/item/ammo_casing/a45,
/turf/template_noop,
/area/submap/CaveS)
"ak" = (
/turf/simulated/floor/outdoors/dirt{
	outdoors = 0
	},
/area/submap/CaveS)
"al" = (
/obj/item/reagent_containers/food/snacks/xenomeat/spidermeat,
/turf/template_noop,
/area/submap/CaveS)
"am" = (
/obj/effect/spider/stickyweb,
/turf/simulated/floor/outdoors/dirt,
/area/submap/CaveS)
"an" = (
/obj/item/clothing/accessory/storage/webbing,
/obj/item/material/knife/tacknife/combatknife,
/turf/simulated/floor/outdoors/dirt{
	outdoors = 0
	},
/area/submap/CaveS)
"ao" = (
/mob/living/simple_mob/animal/giant_spider,
/turf/simulated/floor/outdoors/dirt{
	outdoors = 0
	},
/area/submap/CaveS)
"ap" = (
/obj/effect/decal/cleanable/cobweb,
/turf/simulated/floor/outdoors/dirt{
	outdoors = 0
	},
/area/submap/CaveS)
"aq" = (
/obj/random/mob/spider,
/turf/simulated/floor/outdoors/dirt{
	outdoors = 0
	},
/area/submap/CaveS)
"ar" = (
/mob/living/simple_mob/animal/giant_spider/lurker{
	loot_list = list(/obj/item/stock_parts/manipulator/omni = 50)
	},
/turf/simulated/floor/outdoors/dirt{
	outdoors = 0
	},
/area/submap/CaveS)
"as" = (
/obj/effect/decal/cleanable/cobweb2,
/turf/simulated/floor/outdoors/dirt{
	outdoors = 0
	},
/area/submap/CaveS)
"at" = (
/mob/living/simple_mob/animal/giant_spider/webslinger,
/turf/simulated/floor/outdoors/dirt{
	outdoors = 0
	},
/area/submap/CaveS)
"au" = (
/obj/effect/decal/cleanable/cobweb2,
/mob/living/simple_mob/animal/giant_spider/lurker,
/turf/simulated/floor/outdoors/dirt{
	outdoors = 0
	},
/area/submap/CaveS)
"av" = (
/turf/simulated/floor/outdoors/grass/sif/forest,
/area/submap/CaveS)
"aw" = (
/obj/random/mob/spider/mutant,
/turf/simulated/floor/outdoors/dirt{
	outdoors = 0
	},
/area/submap/CaveS)
"ax" = (
/mob/living/simple_mob/animal/giant_spider/lurker{
	loot_list = list(/obj/item/stock_parts/manipulator/omni = 50)
	},
/turf/simulated/floor/outdoors/dirt,
/area/submap/CaveS)
"ay" = (
/obj/structure/flora/tree/sif,
/turf/simulated/floor/outdoors/grass/sif/forest,
/area/submap/CaveS)
"az" = (
/obj/random/landmine,
/turf/simulated/floor/outdoors/grass/sif/forest,
/area/submap/CaveS)
"aA" = (
/turf/simulated/floor,
/area/submap/CaveS)
"aB" = (
/obj/structure/closet/crate,
/obj/item/stack/cable_coil,
/obj/item/stack/cable_coil,
/obj/item/storage/toolbox,
/obj/random/toolbox,
/turf/simulated/floor,
/area/submap/CaveS)
"aC" = (
/obj/structure/loot_pile/maint/technical,
/turf/simulated/floor,
/area/submap/CaveS)
"aD" = (
/obj/structure/table/woodentable,
/turf/simulated/floor,
/area/submap/CaveS)
"aE" = (
/obj/machinery/power/port_gen/pacman,
/obj/structure/cable{
	icon_state = "0-2"
	},
/turf/simulated/floor,
/area/submap/CaveS)
"aF" = (
/turf/simulated/wall,
/area/submap/CaveS)
"aG" = (
/obj/structure/closet/crate,
/obj/item/reagent_containers/hypospray,
/obj/item/reagent_containers/glass/bottle/stoxin,
/obj/item/reagent_containers/glass/bottle/antitoxin,
/obj/item/reagent_containers/pill/antitox,
/obj/item/reagent_containers/pill/antitox,
/obj/item/reagent_containers/pill/antitox,
/obj/item/reagent_containers/pill/paracetamol,
/turf/simulated/floor,
/area/submap/CaveS)
"aH" = (
/obj/structure/cable{
	icon_state = "1-2";
	pixel_y = 0
	},
/turf/simulated/floor,
/area/submap/CaveS)
"aI" = (
/obj/structure/closet/crate,
/obj/random/contraband,
/obj/random/contraband,
/obj/random/contraband,
/obj/item/material/star,
/obj/item/material/star,
/obj/item/material/star,
/obj/item/material/star,
/obj/item/material/star,
/turf/simulated/floor,
/area/submap/CaveS)
"aJ" = (
/obj/effect/spider/stickyweb,
/mob/living/simple_mob/animal/giant_spider/lurker,
/turf/simulated/floor/outdoors/dirt{
	outdoors = 0
	},
/area/submap/CaveS)
"aK" = (
/obj/structure/cable{
	icon_state = "1-4"
	},
/turf/simulated/floor,
/area/submap/CaveS)
"aL" = (
/obj/structure/cable{
	icon_state = "4-8";
	pixel_x = 0
	},
/turf/simulated/floor,
/area/submap/CaveS)
"aM" = (
/obj/machinery/computer/communications,
/obj/structure/cable{
	icon_state = "0-8"
	},
/turf/simulated/floor,
/area/submap/CaveS)
"aN" = (
/obj/structure/loot_pile/maint/boxfort,
/turf/simulated/floor,
/area/submap/CaveS)
"aO" = (
/mob/living/simple_mob/animal/giant_spider/lurker{
	loot_list = list(/obj/item/stock_parts/capacitor/omni = 50)
	},
/turf/simulated/floor/outdoors/dirt/turfpack/sif{
	outdoors = 0
	},
/area/submap/CaveS)
"aP" = (
/turf/simulated/floor/outdoors/dirt/turfpack/sif{
	outdoors = 0
	},
/area/submap/CaveS)
"aQ" = (
/obj/effect/spider/stickyweb,
/turf/simulated/floor/outdoors/dirt/turfpack/sif{
	outdoors = 0
	},
/area/submap/CaveS)
"aR" = (
/obj/random/mob/spider/mutant,
/turf/simulated/floor/outdoors/dirt/turfpack/sif{
	outdoors = 0
	},
/area/submap/CaveS)
"aS" = (
/turf/simulated/floor/plating/turfpack/sif,
/area/submap/CaveS)
"aT" = (
/obj/structure/loot_pile/maint/boxfort,
/turf/simulated/floor/plating/turfpack/sif,
/area/submap/CaveS)
"aU" = (
/obj/effect/spider/stickyweb,
/mob/living/simple_mob/animal/giant_spider/lurker,
/turf/simulated/floor/outdoors/dirt/turfpack/sif{
	outdoors = 0
	},
/area/submap/CaveS)
"aV" = (
/obj/structure/cable{
	icon_state = "1-4"
	},
/turf/simulated/floor/plating/turfpack/sif,
/area/submap/CaveS)
"aW" = (
/mob/living/simple_mob/animal/giant_spider/lurker{
	loot_list = list(/obj/item/stock_parts/capacitor/omni = 50)
	},
/turf/simulated/floor/outdoors/dirt{
	outdoors = 0
	},
/area/submap/CaveS)
"aX" = (
/obj/structure/cable{
	icon_state = "4-8";
	pixel_x = 0
	},
/turf/simulated/floor/plating/turfpack/sif,
/area/submap/CaveS)
"aY" = (
/obj/machinery/computer/communications,
/obj/structure/cable{
	icon_state = "0-8"
	},
/turf/simulated/floor/plating/turfpack/sif,
/area/submap/CaveS)
"aZ" = (
/mob/living/simple_mob/animal/giant_spider/lurker{
	loot_list = list(/obj/item/stock_parts/capacitor/omni = 50)
	},
/turf/simulated/floor/outdoors/dirt,
/area/submap/CaveS)
"ba" = (
/obj/structure/cable{
	icon_state = "1-2";
	pixel_y = 0
	},
/turf/simulated/floor/plating/turfpack/sif,
/area/submap/CaveS)
"bb" = (
/turf/simulated/wall/turfpack/sif,
/area/submap/CaveS)
"bc" = (
/obj/structure/closet/crate,
/obj/random/contraband,
/obj/random/contraband,
/obj/random/contraband,
/obj/item/material/star,
/obj/item/material/star,
/obj/item/material/star,
/obj/item/material/star,
/obj/item/material/star,
/turf/simulated/floor/plating/turfpack/sif,
/area/submap/CaveS)
"bd" = (
/obj/machinery/power/port_gen/pacman,
/obj/structure/cable{
	icon_state = "0-2"
	},
/turf/simulated/floor/plating/turfpack/sif,
/area/submap/CaveS)
"be" = (
/obj/structure/closet/crate,
/obj/item/reagent_containers/hypospray,
/obj/item/reagent_containers/glass/bottle/stoxin,
/obj/item/reagent_containers/glass/bottle/antitoxin,
/obj/item/reagent_containers/pill/antitox,
/obj/item/reagent_containers/pill/antitox,
/obj/item/reagent_containers/pill/antitox,
/obj/item/reagent_containers/pill/paracetamol,
/turf/simulated/floor/plating/turfpack/sif,
/area/submap/CaveS)
"bf" = (
/obj/random/landmine,
/turf/simulated/floor/outdoors/dirt/turfpack/sif{
	outdoors = 0
	},
/area/submap/CaveS)
"bg" = (
/obj/structure/table/woodentable,
/turf/simulated/floor/plating/turfpack/sif,
/area/submap/CaveS)
"bh" = (
/obj/structure/loot_pile/maint/technical,
/turf/simulated/floor/plating/turfpack/sif,
/area/submap/CaveS)
"bi" = (
/obj/structure/closet/crate,
/obj/item/stack/cable_coil,
/obj/item/stack/cable_coil,
/obj/item/storage/toolbox,
/obj/random/toolbox,
/turf/simulated/floor/plating/turfpack/sif,
/area/submap/CaveS)
"bj" = (
/obj/random/mob/spider,
/turf/simulated/floor/outdoors/dirt/turfpack/sif{
	outdoors = 0
	},
/area/submap/CaveS)
"bk" = (
/mob/living/simple_mob/animal/giant_spider/lurker{
	loot_list = list(/obj/item/stock_parts/manipulator/omni = 50)
	},
/turf/simulated/floor/outdoors/dirt/turfpack/sif{
	outdoors = 0
	},
/area/submap/CaveS)
"bl" = (
/mob/living/simple_mob/animal/giant_spider/webslinger,
/turf/simulated/floor/outdoors/dirt/turfpack/sif{
	outdoors = 0
	},
/area/submap/CaveS)
"bm" = (
/obj/effect/decal/cleanable/cobweb2,
/mob/living/simple_mob/animal/giant_spider/lurker,
/turf/simulated/floor/outdoors/dirt/turfpack/sif{
	outdoors = 0
	},
/area/submap/CaveS)
"bn" = (
/obj/effect/decal/cleanable/cobweb2,
/turf/simulated/floor/outdoors/dirt/turfpack/sif{
	outdoors = 0
	},
/area/submap/CaveS)
"bo" = (
/obj/effect/decal/cleanable/cobweb,
/turf/simulated/floor/outdoors/dirt/turfpack/sif{
	outdoors = 0
	},
/area/submap/CaveS)
"bp" = (
/mob/living/simple_mob/animal/giant_spider,
/turf/simulated/floor/outdoors/dirt/turfpack/sif{
	outdoors = 0
	},
/area/submap/CaveS)
"bq" = (
/obj/item/clothing/accessory/storage/webbing,
/obj/item/material/knife/tacknife/combatknife,
/turf/simulated/floor/outdoors/dirt/turfpack/sif{
	outdoors = 0
	},
/area/submap/CaveS)

(1,1,1) = {"
aa
aa
aa
aa
aa
aa
aa
aa
aa
aa
aa
aa
aa
aa
aa
aa
aa
aa
aa
aa
aa
aa
aa
aa
aa
aa
aa
aa
aa
aa
aa
aa
aa
aa
aa
aa
aa
aa
aa
aa
"}
(2,1,1) = {"
aa
ab
ab
ab
ab
ab
ab
ab
ab
ab
ab
ab
ab
ab
ab
ab
ab
ab
ab
ab
ab
ab
ab
ab
ab
ab
ab
ab
ab
ab
ab
ab
ab
ab
ab
ab
ab
ab
ab
aa
"}
(3,1,1) = {"
aa
ab
ab
ab
ab
ab
ab
ab
ab
ab
ab
ab
ab
ab
ab
ab
ab
ab
ad
ad
ad
ad
ad
ad
ad
ad
ad
ad
ad
ad
ad
ad
ad
ab
ab
ab
ab
ab
ab
aa
"}
(4,1,1) = {"
aa
ab
ab
ab
ab
ab
ab
ab
ab
ab
ab
ab
ab
ab
ad
ad
ad
ad
ad
ad
ad
ad
ad
ad
ad
ad
ad
ad
ad
ad
ad
ad
ad
ad
ad
ad
ab
ab
ab
aa
"}
(5,1,1) = {"
aa
ab
ab
ab
ab
ab
ab
ab
ab
ab
ab
ad
ad
ad
ad
ad
ad
ad
ad
ad
ad
ad
ad
ad
av
av
ad
ad
av
av
ad
ad
ad
ad
ad
ad
ad
ad
ad
aa
"}
(6,1,1) = {"
aa
ab
ab
ab
ab
ab
ab
ab
ab
ad
ad
ad
ad
ad
ad
ad
ad
ad
ad
ad
ad
ad
ad
av
ay
av
av
av
av
av
av
ad
ad
ad
ad
ad
ad
ad
ad
aa
"}
(7,1,1) = {"
aa
ab
ab
ab
ab
ab
ab
ab
ab
ad
ad
ad
ad
ad
ad
bp
aQ
ad
ad
ad
ad
ad
ad
av
av
az
av
av
av
av
av
ad
ad
ad
ad
ad
ad
ad
ab
aa
"}
(8,1,1) = {"
aa
ab
ab
ab
ab
ab
ab
ab
ab
ad
ad
ad
ad
ad
ad
aP
aP
aP
ad
ad
ad
ad
av
av
av
av
av
av
av
av
av
ay
ad
ad
ad
ad
ad
ad
ab
aa
"}
(9,1,1) = {"
aa
ab
ab
ab
ab
ab
ab
ab
ab
ad
ad
ad
ad
ad
bq
aP
aP
bj
ad
ad
ad
ad
av
av
av
av
ay
az
av
av
av
av
ad
ad
ad
ad
ad
ab
ab
aa
"}
(10,1,1) = {"
aa
ab
ab
ab
ab
ab
ab
ab
ab
ad
ad
ad
ad
ad
ad
aP
aP
aP
aP
aP
ad
ad
ad
ad
ad
av
av
av
av
av
av
aP
av
ad
ad
ad
ad
ab
ab
aa
"}
(11,1,1) = {"
aa
ab
ab
ab
ab
ab
ab
ab
ab
ab
ad
ad
ad
ad
aP
aP
aP
aP
aP
aP
aP
ad
ad
ad
ad
ad
aQ
aP
av
aP
aP
aP
aQ
ad
ad
ad
ad
ab
ab
aa
"}
(12,1,1) = {"
aa
ab
ab
ab
ab
ab
ab
ab
ab
ab
ad
ad
ad
ad
aP
aP
aP
aP
aP
aP
aP
bl
ad
ad
ad
ad
ad
aP
aP
aP
aP
ad
ad
ad
ad
ad
ad
ab
ab
aa
"}
(13,1,1) = {"
aa
ab
ab
ab
ab
ab
ab
ab
ab
ab
ad
ad
ad
ad
aQ
aP
bk
ad
aP
aP
aP
aP
ad
ad
ad
ad
ad
aP
aP
ad
aO
ad
ad
ad
ad
ad
ad
ad
ab
aa
"}
(14,1,1) = {"
aa
ab
ab
ab
ab
ab
ab
ab
ab
ab
ab
ad
ad
ad
ad
ad
ad
ad
ad
bn
aP
aP
ad
ad
ad
ad
ad
aP
aP
ad
ad
ad
ad
ad
ad
ad
ad
ad
ad
aa
"}
(15,1,1) = {"
aa
ab
ab
ab
ab
ab
ab
ab
ab
ac
ab
ab
ad
ad
ad
ad
ad
ad
ad
ad
aP
aP
aR
aP
aP
ad
ad
aP
aP
ad
ad
ad
ad
ad
ad
ad
ad
ad
ad
aa
"}
(16,1,1) = {"
aa
ab
ab
ab
ab
ab
ab
ab
ab
ab
ab
ab
ab
ad
ad
ad
ab
ab
ad
ad
aP
aP
aP
aP
aP
aP
aP
aP
aQ
ad
ad
ad
ad
ad
ad
ad
ad
ad
ad
aa
"}
(17,1,1) = {"
aa
ab
ab
ab
ab
ab
ac
ab
ab
ab
ab
ab
ab
ab
ab
ab
ab
ad
ad
ad
aP
aP
ad
ad
aO
aP
aP
aP
ad
ad
ad
ad
ad
ad
ad
ad
ad
ad
ad
aa
"}
(18,1,1) = {"
aa
ab
ab
ab
ab
ab
ab
ab
ab
ab
ab
ab
ab
ab
ab
ab
ad
ad
ad
ad
aP
aP
ad
ad
ad
aP
aP
ad
ad
ad
ad
aQ
aU
aP
ad
ad
ad
ad
ab
aa
"}
(19,1,1) = {"
aa
ab
ab
ab
ab
ab
ab
ab
ab
ab
aj
ac
ab
ab
ad
ad
ad
ad
ad
ad
aP
aP
ad
ad
ad
aP
aP
aP
ad
ad
ad
aP
aP
aP
aP
ad
ad
ad
ab
aa
"}
(20,1,1) = {"
aa
ab
ab
ab
ab
ab
ab
ab
ab
ag
ab
ab
ab
ab
ad
ad
ad
ad
ad
bo
aP
aP
bk
ad
ad
aP
aP
aP
aQ
ad
aP
aP
aP
aP
aQ
ad
ad
ab
ab
aa
"}
(21,1,1) = {"
aa
ab
ab
ab
ab
ab
ab
ab
ab
ab
ab
al
ab
ad
ad
ad
ad
ad
ad
aP
aP
aP
ad
ad
ad
ad
aP
aP
aP
aP
aP
aP
aP
aP
ad
ad
ad
ab
ab
aa
"}
(22,1,1) = {"
aa
ab
ab
ab
ab
ab
ab
ab
ab
ab
af
ab
ad
ad
ad
ad
ad
ad
ad
bj
aP
aP
ad
ad
ad
ad
aP
aP
aP
bf
aP
aP
aP
aP
ad
ad
ad
ad
ad
aa
"}
(23,1,1) = {"
aa
ab
ab
ab
ac
ab
ab
ab
af
ab
ab
ad
ad
ad
ad
ad
ad
ad
ad
aP
aP
aP
ad
ad
ad
ad
bf
aP
aP
aP
aQ
ad
ad
ad
ad
ad
ad
ad
ab
aa
"}
(24,1,1) = {"
aa
ab
ab
ab
ab
ab
ac
ab
ab
bf
aP
aQ
ad
ad
ad
ad
ad
ad
ad
aP
aP
aP
ad
ad
ad
ad
aQ
aQ
bf
aP
ad
ad
ad
ad
ad
ad
ad
ad
ab
aa
"}
(25,1,1) = {"
aa
ab
ab
ab
ab
ab
ac
ae
ad
aQ
aP
aP
aQ
ad
ad
ad
ad
ad
ad
aP
aP
aP
ad
ad
ad
ad
ad
ad
aP
aP
aP
aP
aP
ad
ad
ad
ad
ad
ad
aa
"}
(26,1,1) = {"
aa
ab
ab
ab
ab
ab
ac
ad
ad
ad
ad
aQ
aP
ad
ad
bo
aP
aP
bf
aP
aP
aP
aQ
ad
ad
ad
ad
ad
aP
aP
aP
aP
aP
aP
aR
ad
ad
ad
ad
aa
"}
(27,1,1) = {"
aa
ab
ab
ab
ab
ab
ad
ad
ad
ad
ad
aQ
aP
bf
aP
aP
aP
aP
aP
ad
ad
aP
aP
aP
ad
ad
ad
aP
aP
aP
aS
aS
aS
aP
aP
aO
ad
ad
ad
aa
"}
(28,1,1) = {"
aa
ab
ab
ab
ab
ab
ad
ad
ad
ad
ad
ad
aP
aP
aP
aP
aP
ad
ad
ad
ad
bm
aP
aP
ad
ad
aP
aP
aP
aS
bd
ba
aV
aP
aP
aP
ad
ad
ad
aa
"}
(29,1,1) = {"
aa
ab
ab
ab
ab
ab
ad
ad
ad
ad
ad
ad
ad
aQ
aP
aP
aP
ad
ad
ad
ad
ad
aP
aP
ad
aO
aP
aS
aS
bg
bb
bb
aX
aS
aS
aP
ad
ad
ad
aa
"}
(30,1,1) = {"
aa
ab
ab
ab
ab
ab
ad
ad
ad
ad
ad
ad
ad
ad
aP
aP
aP
ad
ad
ad
ad
ad
aP
aP
ad
aP
aP
aS
aS
bg
bb
bb
aY
aS
aT
ad
ad
ad
ab
aa
"}
(31,1,1) = {"
aa
ab
ab
ab
ab
ab
ad
ad
ad
ad
ad
ad
ad
ad
aP
aP
aP
ad
ad
bo
bf
aP
aP
bj
ad
ad
aP
bi
aS
aS
be
bc
aS
aS
ad
ad
ad
ab
ab
aa
"}
(32,1,1) = {"
aa
ab
ab
ab
ab
ab
ab
ad
ad
ad
ad
ad
ad
ad
aP
aP
aP
aP
aP
aP
aP
aP
aP
ad
ad
ad
aP
aP
bh
aS
aR
aP
aS
ad
ad
ad
ab
ab
ab
aa
"}
(33,1,1) = {"
aa
ab
ab
ab
ab
ab
ab
ad
ad
ad
ad
ad
ad
ad
ad
bj
ad
bn
aP
ad
ad
ad
ad
ad
ad
ad
ad
aP
aP
aP
aP
aP
ad
ad
ad
ad
ab
ab
ab
aa
"}
(34,1,1) = {"
aa
ab
ab
ab
ab
ab
ab
ab
ad
ad
ad
ad
ad
ad
ad
ad
ad
ad
ad
ad
ad
ad
ad
ad
ad
ad
ad
aP
ad
aP
aP
ad
ad
ad
ad
ab
ab
ab
ab
aa
"}
(35,1,1) = {"
aa
ab
ab
ab
ab
ab
ab
ab
ad
ad
ad
ad
ad
ad
ad
ad
ad
ad
ad
ad
ad
ad
ad
ad
ad
ad
ad
ad
ad
ad
ad
ad
ad
ad
ad
ab
ab
ab
ab
aa
"}
(36,1,1) = {"
aa
ab
ab
ab
ab
ab
ab
ad
ad
ad
ad
ad
ab
ab
ad
ad
ad
ad
ad
ad
ad
ad
ad
ad
ad
ad
ab
ad
ad
ad
ad
ad
ad
ad
ab
ab
ab
ab
ab
aa
"}
(37,1,1) = {"
aa
ab
ab
ab
ab
ab
ab
ad
ad
ad
ad
ab
ab
ab
ab
ab
ad
ad
ad
ad
ad
ad
ad
ad
ab
ab
ab
ab
ab
ab
ad
ad
ab
ab
ab
ab
ab
ab
ab
aa
"}
(38,1,1) = {"
aa
ab
ab
ab
ab
ab
ab
ab
ab
ab
ab
ab
ab
ab
ab
ab
ab
ab
ad
ad
ad
ad
ad
ab
ab
ab
ab
ab
ab
ab
ab
ab
ab
ab
ab
ab
ab
ab
ab
aa
"}
(39,1,1) = {"
aa
ab
ab
ab
ab
ab
ab
ab
ab
ab
ab
ab
ab
ab
ab
ab
ab
ab
ab
ab
ad
ad
ab
ab
ab
ab
ab
ab
ab
ab
ab
ab
ab
ab
ab
ab
ab
ab
ab
aa
"}
(40,1,1) = {"
aa
aa
aa
aa
aa
aa
aa
aa
aa
aa
aa
aa
aa
aa
aa
aa
aa
aa
aa
aa
aa
aa
aa
aa
aa
aa
aa
aa
aa
aa
aa
aa
aa
aa
aa
aa
aa
aa
aa
aa
"}
